########
#  X  O#
#  PX  #
#O #####
#  X  O#
########
